0 10 10 0 8 9 7
2 1 6 1 6 3 4 2 2 2 
10 2 11 6 11 13 7 13 15 14 
11 12 10 9 13 4 8 3 14 8 
11 7 15 4 3 4 2 8 9 6 
10 10 11 5 13 7 15 6 1 14 
10 8 11 5 4 10 8 10 2 8 
9 6 10 2 1 12 1 13 15 6 
3 14 11 13 7 7 6 1 14 8 
8 10 11 4 8 10 8 1 15 4 
1 12 9 5 4 9 5 4 9 4 
