0 25 25 0 19 0 13
2 1 5 7 5 7 6 2 2 2 2 3 5 4 1 7 6 2 3 4 1 7 4 3 6 
9 6 2 8 2 10 9 12 10 10 10 11 6 1 7 12 9 12 10 1 7 15 4 10 8 
1 13 14 1 15 15 6 1 14 9 14 10 8 2 10 2 2 1 15 5 12 9 5 13 4 
3 4 11 4 8 10 8 2 9 6 10 11 5 12 9 14 9 6 11 5 5 4 2 2 2 
11 5 13 5 6 9 5 14 2 9 15 13 5 4 2 10 1 14 9 7 7 5 13 15 12 
9 4 1 6 9 6 1 13 15 5 13 5 4 2 11 12 3 13 5 12 8 2 1 12 2 
2 2 1 14 2 10 3 4 9 7 5 4 2 10 11 4 11 5 5 5 4 10 2 1 14 
9 15 7 13 13 13 14 2 1 15 4 2 10 10 11 5 15 4 2 2 1 15 13 5 14 
2 8 8 3 7 4 9 14 2 9 7 14 9 13 14 1 13 5 12 11 7 13 5 4 8 
11 4 1 12 11 5 5 13 13 7 12 8 1 7 14 2 2 2 2 10 11 4 2 2 2 
9 6 1 6 8 2 1 7 5 15 4 2 1 14 9 13 15 13 13 14 11 7 15 14 10 
1 15 4 10 2 11 7 12 1 15 6 11 4 10 2 1 15 4 2 8 8 10 10 9 14 
1 13 7 13 13 14 8 2 1 12 9 15 7 15 13 6 9 4 11 5 4 8 8 2 8 
3 5 13 6 1 15 4 10 2 2 1 12 10 11 6 9 7 7 14 2 2 3 4 10 2 
8 1 6 10 2 10 1 13 13 13 7 7 12 10 9 4 8 10 11 13 13 12 1 14 10 
3 5 15 13 12 10 1 5 5 7 12 9 6 11 5 4 2 8 11 5 4 2 2 11 14 
8 1 14 1 5 12 3 7 5 13 6 2 10 11 5 5 13 6 9 5 7 15 13 14 8 
3 5 14 2 1 5 14 8 3 7 15 14 8 11 4 2 2 11 5 4 10 11 4 11 6 
11 4 11 13 4 3 15 4 8 10 8 11 6 11 5 13 12 8 2 2 8 9 4 8 10 
10 1 15 6 3 12 8 1 6 8 1 14 8 8 2 1 6 2 11 12 2 3 4 1 12 
8 1 12 8 8 1 5 5 15 4 1 15 5 7 15 5 13 15 15 5 12 11 5 5 4 
1 7 6 3 4 3 5 5 15 5 7 15 6 8 10 2 3 14 9 7 5 15 4 2 2 
2 8 11 15 5 12 2 3 12 3 14 10 8 2 11 12 8 10 2 8 3 15 5 15 12 
11 5 12 10 1 5 15 13 6 10 8 10 2 9 15 7 4 9 15 4 10 10 2 8 2 
8 1 5 12 1 5 12 1 12 8 1 13 12 1 12 9 4 1 13 4 8 9 13 5 12 
